R 1024 768
F ./pics/colorstone.xpm
C ./pics/purplestone.xpm
NO ./pics/redbrick.xpm
SO ./pics/greystone.xpm
WE ./pics/wood.xpm
EA ./pics/bluestone.xpm
S ./pics/heart.xpm
S2 ./pics/trap.xpm
111111111111111111111111111111111111111
100000000000000001100000000000000000001
100030000300030000000004003000000000001
1E0000000000030001110000003000000000001
100000040030000002220004003000000000001
100000000000030001111110000000000000001
111111111111111111111111111111111111111
