R 800 600
C 255,200,160
F 122,122,122
NO ./pics/redbrick.xpm
SO ./pics/greystone.xpm
WE ./pics/wood.xpm
EA ./pics/bluestone.xpm
S ./pics/barrel.xpm

1111111
1002001
100S001
1002001
1111111
